30	30
1	1	1	1	1	1	1	1	50	50	50	50	50	50	50	50	50	50	50	50	50	50	50	50	50	50	20	20	20	2
1	1	1	1	1	1	1	1	50	50	50	50	50	50	50	50	50	50	50	50	50	50	50	20	20	50	20	50	20	2
50	50	1	1	1	50	50	50	50	50	50	50	50	50	50	50	50	50	50	50	50	50	50	20	20	50	20	50	20	2
50	50	1	1	1	50	50	50	50	50	50	50	50	50	50	50	50	50	50	50	50	50	50	20	20	50	20	50	20	2
50	50	1	1	1	50	50	50	50	50	50	50	50	50	50	50	50	50	50	50	50	50	50	20	20	50	50	50	50	2
50	50	1	1	1	50	50	50	50	50	50	50	50	50	50	50	50	50	50	50	50	50	50	20	20	20	20	20	20	2
50	50	1	1	1	50	50	50	50	50	50	50	50	50	50	50	50	50	50	50	50	50	50	20	50	50	50	50	50	2
1	1	1	1	1	1	1	50	50	50	50	50	50	50	50	50	50	50	50	50	50	50	50	20	50	20	50	20	20	20
1	1	1	1	1	1	1	50	50	50	50	50	50	50	50	50	50	50	50	50	20	20	20	20	50	20	50	50	50	2
1	1	1	1	1	1	1	50	50	50	50	50	50	50	50	50	50	50	50	50	20	50	50	50	50	20	50	20	20	20
50	50	50	50	50	50	50	50	50	50	50	50	50	50	50	50	50	50	50	50	20	50	20	20	20	20	50	20	20	2
50	50	50	50	50	50	50	50	50	50	50	50	50	50	50	50	50	50	50	50	50	50	20	50	50	50	50	20	50	2
50	50	50	50	50	50	50	50	50	50	50	50	50	50	50	50	50	50	50	50	20	50	20	39	20	20	20	20	20	2
50	50	50	50	50	50	50	50	50	50	50	50	50	50	50	50	50	50	20	20	20	20	20	50	50	50	50	50	50	2
50	50	50	50	50	50	50	50	50	50	50	50	50	50	50	50	50	50	20	50	50	50	20	10	10	10	50	20	20	2
50	50	50	50	50	50	50	50	50	50	50	50	50	50	50	50	50	50	20	50	20	50	20	20	50	50	50	20	50	2
50	50	50	50	50	50	50	50	50	50	50	50	50	50	50	50	50	50	20	50	20	50	50	20	20	20	20	20	50	2
50	50	50	50	50	50	50	50	50	50	50	50	50	50	50	50	20	20	20	50	20	50	50	20	50	50	50	20	50	2
50	50	50	50	50	50	50	50	50	50	50	50	50	50	50	50	20	50	50	50	20	50	50	20	50	20	50	20	50	2
50	50	50	50	50	50	50	50	50	50	50	50	50	50	50	50	20	50	50	20	20	50	50	20	50	20	50	20	50	2
50	50	50	50	50	50	50	50	50	50	50	50	20	20	20	20	20	50	50	20	20	50	50	50	50	20	50	20	20	2
50	50	50	50	50	50	50	50	50	50	50	50	20	50	50	50	50	50	50	50	20	50	50	20	50	20	50	50	20	2
50	50	50	50	50	50	50	50	50	50	50	50	20	50	20	20	20	20	20	50	20	50	50	20	50	20	50	50	20	2
50	50	50	50	50	50	50	50	50	50	50	50	20	50	50	50	50	50	20	50	20	50	50	20	50	20	50	50	20	2
50	50	50	50	50	50	50	50	50	50	50	50	20	20	20	50	50	50	20	50	20	50	50	20	20	20	50	20	20	2
50	50	50	50	50	50	50	50	50	20	20	50	50	50	20	50	20	20	20	50	20	50	50	20	50	50	50	50	50	2
50	50	50	50	50	50	50	50	50	20	50	20	20	50	20	50	20	50	50	50	20	50	50	20	50	20	20	20	50	20
50	50	50	50	50	50	50	50	50	50	50	20	50	50	20	50	20	50	50	20	20	20	20	20	50	20	50	20	50	2
50	50	50	50	50	50	50	50	50	20	20	20	50	50	50	50	20	50	50	20	50	50	50	50	50	20	50	20	50	2
50	50	50	50	50	50	50	50	50	50	50	50	50	50	50	50	20	20	50	20	50	50	50	20	50	50	50	20	50	2
END
0	0	0	0	0	0	0	0	1	1	1	1	1	1	1	1	1	1	1	1	1	1	1	1	1	1	0	0	0	1
0	0	0	0	0	0	0	0	1	1	1	1	1	1	1	1	1	1	1	1	1	1	1	0	0	1	0	1	0	1
1	1	0	0	0	1	1	1	1	1	1	1	1	1	1	1	1	1	1	1	1	1	1	0	0	1	0	1	0	1
1	1	0	0	0	1	1	1	1	1	1	1	1	1	1	1	1	1	1	1	1	1	1	0	0	1	0	1	0	1
1	1	0	0	0	1	1	1	1	1	1	1	1	1	1	1	1	1	1	1	1	1	1	0	0	1	1	1	1	1
1	1	0	0	0	1	1	1	1	1	1	1	1	1	1	1	1	1	1	1	1	1	1	0	0	0	0	0	0	1
1	1	0	0	0	1	1	1	1	1	1	1	1	1	1	1	1	1	1	1	1	1	1	0	1	1	1	1	1	1
0	0	0	0	0	0	0	1	1	1	1	1	1	1	1	1	1	1	1	1	1	1	1	0	1	0	1	0	0	0
0	0	0	0	0	0	0	1	1	1	1	1	1	1	1	1	1	1	1	1	0	0	0	0	1	0	1	1	1	1
0	0	0	0	0	0	0	1	1	1	1	1	1	1	1	1	1	1	1	1	0	1	1	1	1	0	1	0	0	0
1	1	1	1	1	1	1	1	1	1	1	1	1	1	1	1	1	1	1	1	0	1	0	0	0	0	1	0	0	1
1	1	1	1	1	1	1	1	1	1	1	1	1	1	1	1	1	1	1	1	1	1	0	1	1	1	1	0	1	1
1	1	1	1	1	1	1	1	1	1	1	1	1	1	1	1	1	1	1	1	0	1	0	0	0	0	0	0	0	1
1	1	1	1	1	1	1	1	1	1	1	1	1	1	1	1	1	1	0	0	0	0	0	1	1	1	1	1	1	1
1	1	1	1	1	1	1	1	1	1	1	1	1	1	1	1	1	1	0	1	1	1	0	0	0	0	1	0	0	1
1	1	1	1	1	1	1	1	1	1	1	1	1	1	1	1	1	1	0	1	0	1	0	0	1	1	1	0	1	1
1	1	1	1	1	1	1	1	1	1	1	1	1	1	1	1	1	1	0	1	0	1	1	0	0	0	0	0	1	1
1	1	1	1	1	1	1	1	1	1	1	1	1	1	1	1	0	0	0	1	0	1	1	0	1	1	1	0	1	1
1	1	1	1	1	1	1	1	1	1	1	1	1	1	1	1	0	1	1	1	0	1	1	0	1	0	1	0	1	1
1	1	1	1	1	1	1	1	1	1	1	1	1	1	1	1	0	1	1	0	0	1	1	0	1	0	1	0	1	1
1	1	1	1	1	1	1	1	1	1	1	1	0	0	0	0	0	1	1	0	0	1	1	1	1	0	1	0	0	1
1	1	1	1	1	1	1	1	1	1	1	1	0	1	1	1	1	1	1	1	0	1	1	0	1	0	1	1	0	1
1	1	1	1	1	1	1	1	1	1	1	1	0	1	0	0	0	0	0	1	0	1	1	0	1	0	1	1	0	1
1	1	1	1	1	1	1	1	1	1	1	1	0	1	1	1	1	1	0	1	0	1	1	0	1	0	1	1	0	1
1	1	1	1	1	1	1	1	1	1	1	1	0	0	0	1	1	1	0	1	0	1	1	0	0	0	1	0	0	1
1	1	1	1	1	1	1	1	1	0	0	1	1	1	0	1	0	0	0	1	0	1	1	0	1	1	1	1	1	1
1	1	1	1	1	1	1	1	1	0	1	0	0	1	0	1	0	1	1	1	0	1	1	0	1	0	0	0	1	0
1	1	1	1	1	1	1	1	1	1	1	0	1	1	0	1	0	1	1	0	0	0	0	0	1	0	1	0	1	1
1	1	1	1	1	1	1	1	1	0	0	0	1	1	1	1	0	1	1	0	1	1	1	1	1	0	1	0	1	1
1	1	1	1	1	1	1	1	1	1	1	1	1	1	1	1	0	0	1	0	1	1	1	0	1	1	1	0	1	1
END
